B,B,B,B,B,D,D,B,B,B,B,B,
B,-,-,-,-,-,-,-,-,-,-,B,
B,-,-,-,-,-,-,-,-,-,-,B,
B,-,-,-,-,-,-,-,-,-,-,B,
B,-,-,-,-,-,-,-,-,-,-,B,
B,-,-,-,r,r,r,r,-,-,-,B,
B,-,-,-,r,-,-,r,-,-,-,B,
D,-,-,-,-,-,-,-,r,-,-,D,
D,-,-,-,-,-,-,-,r,-,-,D,
B,-,-,-,-,-,-,r,-,-,-,B,
B,-,-,-,-,-,r,-,-,-,-,B,
B,-,-,-,-,r,-,-,-,-,-,B,
B,-,-,-,r,-,-,-,-,-,-,B,
B,-,-,-,-,-,-,-,-,-,-,B,
B,-,-,-,-,-,-,-,-,-,-,B,
B,B,B,B,B,D,D,B,B,B,B,B,
